++++++++++++++++++++++++++++
   +  +    +            +  +
+  +     +++  + +++++++ +  +
+  +  +       ++++    +    +
+  +  +  ++++ +    ++ + ++++
+  +  +  ++++ +  ++     ++++
+     + +     + +++ ++ ++  + 
++++++++  +++++ +++   ++   +
+  +   +  +     +      +   +
+    +    +++++            +
+  + + ++++++++ ++   S     +
++++++++++++++++++++++++++++